w q e q e e w q e w q w w
v g d g f g g f d g f d n
n s d g g x g f g g f c v
v g d g g d g g d s g d n 
v g g g g z g g d g g x n
v g g g g d g g d g f g v
n f d s f d g f g g f d v
v a x g f g g g g s z g n
n f g g f g g f d g f d v
v v n v v n n v v v n v v